    level = [
        "----------------------------------",
        "--             -- -             --",
        "--   --- -- -- -- -   --- -- -- --",
        "-    --- -- --*--     --- -- --*--",
        "-- -       -    - -----   --     -",
        "-    *   -        -   - ----- -- -",
        "-- ----- --- ---- - -       -    -",
        "-  ----- ---- --- - ------- -- ---",
        "-    --- ---- --- - ------  --   -",
        "- ------  --   -  -       -      -",
        "- -*  -- -------- -            - -",
        "- --- -- -      - --------- ---- -",
        "- --- -- - -  - - -          --* -",
        "- --- -- - -  - - - --------------",
        "- --- -- - -  - - -   -   -      -",
        "- --- -- - -  - - - - - - - - -  -",
        "- --- -- - -  - - - - - - - - -  -",
        "- -      - -  - - - - - - - - -  -",
        "- - ------ -  - - - - - - - - -  -",
        "- -        -**- - -   -   -   -  -",
        "- ------------- - -------------- -",
        "-       ------- *W*              -",
        "----------------------------------"]
