level = [
        "----------------------------------",
        "---             - -             --",
        "------ -- ---   - -   --- -- -- --",
        "-      --  --         --- -- --*--",
        "- --------  ----- -----   --     -",
        "-        -      - -   - ----- -- -",
        "-------- --- ---- - -       -    -",
        "-        --   --- - ------- -- ---",
        "---- --- -- - --- - ------  --   -",
        "-               - -        --    -",
        "- ------ -------- -            - -",
        "- ------ -      - --------- ---- -",
        "- ------ - -  - - -          --  -",
        "- ------ - -  - - - --------------",
        "- ------ - -  - - - -   -   -    -",
        "- ------ - -  - - - - - - - - -  -",
        "- ------ - -  - - - - - - - - -  -",
        "- -      - -  - - - - - - - - -  -",
        "- - ------ -  - - - - - - - - -  -",
        "- -        -  - - -   -   -   -  -",
        "- ------------- -*-------------- -",
        "-       ------- *w               -",
        "----------------------------------"]
